46  10
0  0  0  0  0  0  0  0  0  0  0  0  0  0  0  0  0  0  0  0  0  0  0  0  0  0  0  0  0  0  0  0  0  0  0  0  0  0  0  0  0  0  0  0  0  0
0  0  0  0  0  0  0  0  0  0  0  0  0  0  0  0  0  0  0  0  0  0  0  0  0  0  0  0  0  0  0  0  0  0  0  0  0  0  0  0  0  0  0  0  0  0
0  0  0  0  0  0  0  0  0  0  0  0  0  0  0  0  0  0  0  0  0  0  0  0  0  0  0  0  0  0  0  0  0  0  0  0  0  0  0  0  0  0  0  0  0  0
0  0  0  0  0  0  0  0  0 -1  0  0  0  0  0  0  0  0  0  0  0 -2 -2 -2  0  0  0  0  0  0  0  0 -1  0  0  0  0  0  0  0  0  0  0  0  0  6
0  0  0  0  0 -2 -2  0  0  0  0  0  0  0  0  0  0  0  0  0 -2 -2 -2  0  0  0  0  0 -2 -2  0  0  0  0  0  0  0  0  0  0  0  0  0  0  0  2
0  0  0  0  0  0  0  0  0  0  0  0  0  0  0  0  0  0  0  0  0 -2 -2 -3  0  0  0  0 -2 -2  0  0  0  0  0  0  0  0  0  0  0  0  0  0  0  2
0  0  0  0  0  0  0  0  0  0  0  0  0  0  0  0  0  0  0  0  0  6  6  6  0  0  0  0  0  0  0  0  0  0  0  0  0  0  0  0  0  0  0  0  0  2
6  0 -1  0  0  5  5  5  5  0  0  0  0  0  0  0  0  0  0  0  0  0  0  0  0  0 -1  0  6  6  6  6  0  0  0  0  0  0  0  0  6  0  0  0 -4  2
2  6  6  6  6  4  4  4  4  6  6  6  6  6  6  6  6  6  6  6  6  6  6  6  6  6  6  6  2  2  2  2  6  6  6  6  6  6  6  6  2  0  0  6  6  2
2  2  2  2  2  2  2  2  2  2  2  2  2  2  2  2  2  2  2  2  2  2  2  2  2  2  2  2  2  2  2  2  2  2  2  2  2  2  2  2  2  0  0  2  2  2
